W W W W W W W W W W W W W W W W W W W W W W W W W W W W W W W W W W W W W W W W
W O O O O O O O O O O O O O O O O O O O O O O O O O O O O O O O O W W W W W W W
W O O O O O O O O O O O O O O O O O O O O O O O O O O O O O O O O W W W W W W W
W O O O O O O O O O O O O O O O O O O O O O O O O O O O O O O O O W W W W W W W
W O O O O O O O O O O O O O O O O O O O O O O O O O O O O O O O O W W W W W W W
W O O O O O O O O O O O O O O O O O O O O O O O O O O O O O O O O W W W W W W W
W O O W W O O O O W W O O O O W W O O O O W W O O O O W W O O O O W W W W W W W
W O O W W O O O O W W O O O O W W O O O O W W O O O O W W O O O O W W W W W W W
W O O W W O O O O W W O O O O W W O O O O W W O O O O W W O O O O W W W W W W W
W O O W W O O O O W W O O O O W W O O O O W W O O O O W W O O O O W W W W W W W
W O O W W O O O O W W O O O O W W O O O O W W O O O O W W O O O O W W W W W W W
W O O W W O O O O W W O O O O W W O O O O W W O O O O W W O O O O W W W W W W W
W O O W W O O O O W W O O O O W W O O O O W W O O O O W W O O O O W W W W W W W
W O O W W O O O O W W O O O O W W O O O O W W O O O O W W O O O O W W W W W W W
W O O W W O O O O W W O O O O W W O O O O W W O O O O W W O O O O W W W W W W W
W O O W W O O O O W W O O O O W W O O O O W W O O O O W W O O O O W W W W W W W
W O O W W O O O O W W O O O O W W O O O O W W O O O O W W O O O O W W W W W W W
W O O W W O O O O W W O O O O W W O O O O W W O O O O W W O O O O W W W W W W W
W O O W W O O O O W W O O O O W W O O O O W W O O O O W W O O O O W W W W W W W
W O O W W O O O O W W O O O O W W O O O O W W O O O O W W O O O O W W W W W W W
W O O O O O O O O O O O O O O O O O O O O O O O O O O O O O O O O O O O O O O W
W O O O O O O O O O O O O O O O O O O O O O O O O O O O O O O O O O O O O O O W
W O O O O O O O O O O O O O O O O O O O O O O O O O O O O O O O O O O O O O O W
W O O O O O O O O O O O O O O O O O O O O O O O O O O O O O O O O O O O O O O W
W O O O O O O O O O O O O O O O O O O O O O O O O O O O O O O O O O O O O O O E
W O O O O O O O O O O O O O O O O O O O O O O O O O O O O O O O O O O O O O O E
W O O O O O O O O O O O O O O O O O O O O O O O O O O O O O O O O O O O O O O E
W O O O O O O O O O O O O O O O O O O O O O O O O O O O O O O O O O O O O O O E
W W W O O O O O W W W W W W W W W W O O W W W W W W W W W W O O O O O O O O O W
W W W O O O O O W W W W W W W W W W O O W W W W W W W W W W O O O O O O O O O W
W W W O O O O O O O O O O O O O O O O O O O O O O O O O O O O O O O O O O O O W
W W W O O O O O O O O O O O O O O O O O O O O O O O O O O O O O O O O O O O O W
W W W O O O O O O O O O O O O O O O O O O O O O O O O O O O O O O O O O O O O W
W W W O O O O O O O O O O O O O O O O O O O O O O O O O O O O O O W W W O O O W
W W W O O O O O O O O O O O O O O O O O O O O O O O O O O O O O O W W W O O O W
W W W O O O O O O O O O O O O O O O O O O O O O O O O O O O O O O O O O O O O W
W W W O O O O O O O O O O O O O O O O O O O O O O O O O O O O O O O O O O O O W
W W W O O O O O O O O O O O O O O O O O O O O O O O O O O O O O O O O O O O O W
W W W O O O O O W W W W W W W W W A O O W W W W W W W W W W O O O O O O O O O W
W W W O O O O O W W W W W W W W W A O O W W W W W W W W W W O O O O O O O O O W
W W W O O O O O O O O O O O O O O O O O O O O O O O O O O O O O O O O O O O O W
W W W O O O O O O O O O O O O O O O O O O O O O O O O O O O O O O O O O O O O W
W W W O O O O O O O O O O O O O O O O O O O O O O O O O O O O O O O O O O O O W
W W W O O O O O O O O O O O O O O O O O O O O O O O O O O O O O O W W W O O O W
W W W O O O O O O O O O O O O O O O O O O O O O O O O O O O O O O W W W O O O W
W W W O O O O O O O O O O O O O O O O O O O O O O O O O O O O O O O O O O O O W
W W W O O O O O O O O O O O O O O O O O O O O O O O O O O O O O O O O O O O O W
W W W O O O O O O O O O O O O O O O O O O O O O O O O O O O O O O O O O O O O W
W W W O O O O O W W W W W W W W W W O O W W W W W W W W W W O O O O O O O O O W
W W W O O O O O W W W W W W W W W W O O W W W W W W W W W W O O O O O O O O O W
W W W O O O O O O O O O O O O O O O O O O O O O O O O O O O O O O O O O O O O W
W W W O O O O O O O O O O O O O O O O O O O O O O O O O O O O O O O O O O O O W
W W W O O O O O O O O O O O O O O O O O O O O O O O O O O O O O O O O O O O O W
W W W O O O O O O O O O O O O O O O O O O O O O O O O O O O O O O W W W O O O W
W W W O O O O O O O O O O O O O O O O O O O O O O O O O O O O O O W W W O O O W
W W W O O O O O O O O O O O O O O O O O O O O O O O O O O O O O O O O O O O O W
W W W O O O O O O O O O O O O O O O O O O O O O O O O O O O O O O O O O O O O W
W W W O O O O O O O O O O O O O O O O O O O O O O O O O O O O O O O O O O O O W
W W W O O O O O W W W W W W W W W W O O W W W W W W W W W W O O O O O O O O O W
W W W O O O O O W W W W W W W W W W O O W W W W W W W W W W O O O O O O O O O W
W O O O O O O O O O O O O O O O O O O O O O O O O O O O O O O O O O O O O O O W
W O O O O O O O O O O O O O O O O O O O O O O O O O O O O O O O O O O O O O O W
W O O O O O O O O O O O O O O O O O O O O O O O O O O O O O O O O O O O O O O W
E O O O O O O O O O O O O O O O O O O O O O O O O O O O O O O O O W W W O O O W
E O O O O O O O O O O O O O O O O O O O O O O O O O O O W W O O O W W W O O O W
E O O O O O O O O O O O O O O O O O O O O O O O O O O O W W O O O O O O O O O W
E O O O O O O O O O O O O O O O O O O O O O O O O O O O W W O O O O O O O O O W
W O O O O O O O O O O O O O O O O O O O O O O O O O O O W W O O O O O O O O O W
W O O O O O O O W W W W W W W W W W O O W W W W O O O O W W O O O O O O O O O W
W O O O O O O O W W W W W W W W W W O O W W W W O O O O W W O O O O O O O O O W
W O O O O O O O O O O O O O O O O O O O O O O O O O O O W W O O O O O O O O O W
W O O O O O O O O O O O O O O O O O O O O O O O O O O O W W O O O O O O O O O W
W W W O O O O O O O O O O O O O O O O O O O O O O O O O W W O O O O O O O O O W
W W W O O O O O O O O O O O O O O O O O O O O O O O O O W W O O O O O O O O O W
W W W O O O O O O O O O O O O O O O O O O O O O O O O O W W O O O O O O O O O W
W W W O O O O O O O O O O O O O O O O O O O O O O O O O W W O O O O O O O O O W
W W W O O O O O O O O O O O O O O O O O O O O O O O O O W W O O O O O O O O O W
W W W W W O O O W W W W W W W W W W W W W W W W O O O O W W O O O O O O O O O W
W W W W W O O O W W W W W W W W W W W W W W W W O O O O W W O O O O O O O O O W
W W W W W W W W W W W W W W W W W W W W W W W W W W W W W W W W W W W W W W W W
